ahvatle	ma
aita	da
aja	ma
ajenda	ma
akka	ma
alandu	ma
and	da?
annu	da
armasta	da
asu	ma
asuta	ma
eelista	da
hakata	ma
hakka	ma
harju	ma
heit	ma?
hiili	ma?
himusta	da?
häbene	da mast
igatse	da
ihka	da
ilmu	ma?
innusta	ma
inspireeri	ma
jaksa	da
jaluta	ma?
jooks	ma?
juhtu	ma
julge	da
julgusta	ma
jät	mata mast ma
jää	mata ma
jõud	da
jõuta	da
kannata	da?
kart	da
katsu	da
kavanda	da?
kavatse	da
keela	da mast
keeldu	mast
keelita	ma mast
kibele	ma
kihuta	ma?
kiirusta	ma?
kippu	ma
kisku	ma?
kohku	mast
kohusta	ma
kujuta	mas
kujutle	mas
kukku	ma?
kutsu	ma
kuul	mas
käi	mas
kärsi	da
käski	da
kõhele	mast
kõhkle	mast da?
kõlba	da ma
küündi	ma
lahva	ma?
lakka	mast
lask	da ma
lasnu	da
leid	mas
lenda	ma?
lennuta	ma?
lippa	ma?
loobu	mast
loot	da
luba	da
läbe	da
löö	ma?
lükka	ma?
mahtu	ma
maks	da
malda	da
meeldi	da
meelita	ma
mine	ma
motiveeri	ma
märka	da?
mõist	da
mõjuta	ma
mõtestu	da
mõtle	da
naeluta	ma?
näge	mas
nõustu	ma
osata	da
oska	da
otsusta	da
paendu	ma
pahvata	ma
paindu	ma
paist	ma? mas?
palu	da
pane	ma
passi	da
peata	mast
peatu	mast
peleta	ma
pelga	da mast
pida	ma
pist	ma
plaani	da
plaanitse	da
planeeri	ma
pretendeeri	ma
proovi	da
pruuki	da
puhke	ma
pyyagi	da
pääse	ma mast
põlga	da mast
pürgi	ma
püüd	da
püüdle	ma?
raatsi	da
riskeeri	da
riski	da
roni	ma?
rutta	ma
saa	da ma
saat	ma
sattu	ma
sega	mast da?
sobi	da ma
soostu	ma
soovi	da
soovita	da
sundi	ma
suundu	ma
suut	da
suvatse	da
sõit	ma?
söanda	da
söandnu	da
sööst	ma
sündi	da ma?
taba	mas mast
tahnu	da
taht	da
taipa	da
takista	mast da
tarvitse	da
tasu	da
tavatse	da
tead	da
tege	ma da
tihka	da
tikku	ma
tohti	da
torma	ma
trügi	ma
tule	da ma
täi	da
tõmba	ma
tõota	da
tõrju	mast
tõrku	mast
tõtta	ma
tõuka	ma
tüdi	mast
tüdine	mast
tükki	ma
uht	ma?
uinu	ma?
uju	ma?
ulata	ma
ulatu	ma
unusta	mata mast da ma
unune	mata
usalda	da ma?
utsita	ma
vaevu	ma
valmistu	ma
veda	ma?
veen	ma
vii	ma
viibi	mas?
viitsi	da
viivita	mast
viska	ma
volita	ma
välista	mast
välti	mast
väsi	mast
väsita	mast
või	da
võimalda	da
võt	da ma
ähvarda	da
ärgita	ma
õhuta	ma
õigusta	ma
õnnesta	da
õnnestu	da
õpeta	ma
õppi	ma
ürita	da